SO ./assets/textures/purple_stone.xpm
NO ./assets/textures/purple_stone.xpm
WE ./assets/textures/purple_stone.xpm
EA ./assets/textures/purple_stone.xpm

F 38,127,10
C 38,200,45

111111111111111111111111111111111111111111111111111
100000000000000000000000000000000000000000000000001
100000000000000000000000000000000000000000000000001
100000000000000000000000000000000000000000000000001
100000000000000000000000000000000000000000000000001
100000000000000000000000000000000000000000000000001
100000000000000000000000000000000000000000000000001
100000000000000000000000000000000000000000000000001
100000000000000000000000000000000000000000000000001
100000000000000000000000000000000000000000000000001
100000000000000000000000000000000000000000000000001
100000000000000000000000000000000000000000000000001
100000000000000000000000000000000000000000000000001
100000000000000000000000000000000000000000000000001
100000000000000000000000000000000000000000000000001
100000000000000000000000000000000000000000000000001
100000000000000000000000000000000000000000000000001
100000000000000000000000000000000000000000000000001
100000000000000000000000000000000000000000000000001
100000000000000000000000011110000000000000000000001
100000000000000000001111111110000000000000000000001
100000000000000000001000000111100000000000000000001
100000000000000000001011110110000000000000000000001
100000000000000000001011110000100000000000000000001
100000000000000000001000011111100000000000000000001
100000000000000000001111010000000000000000000000001
100000000000000000000001010000000000000000000000001
100000000000000000000001010000000000000000000000001
100000000000000000000001N10000000000000000000000001
100000000000000000000001010000000000000000000000001
111111111111111111111111111111111111111111111111111
