SO ./assets/textures/mossy.xpm
NO ./assets/textures/mossy.xpm
WE ./assets/textures/mossy.xpm
EA ./assets/textures/mossy.xpm

F 55,53,10
C 80,80,4

111111111111111111111111111111111
110000001111111111111111111111111
100000000111111111111111011111111
10000E000000000000000000000111111
110000000000000000000000000011111
110000000000000000000000000011111
100000000000000000000000000111111
100000000111111111111111011111111
110000001111111111111111111111111
111111111111111111111111111111111